   HHHHHHH
 HHH     H
HH   H H H
H  HDBBB H
H HDCH HHH
H  DDH H  
HHHDDB HH 
  HDH B H 
 HH H HWH 
 H B  B H 
 H     HH 
 HHHHHHH    
