      ######
   #####   #
   #   # # #####
   #$$ #       ######
  ##   ### ##$      #
###   $     #  ##   #####
#   $ $ $  @###### ##   #
#  ########$#    # #  # #
## ###      #### # # #  #
 # ### #### ##.. #   $ ##
 #        # ##.. #$##$ ##
 #  # # #     ..## ##   #
 ####   # ## #..#   $ $ #
    #####    #..# # #  ##
        ######$.#   # ##
             #$.#####  #
             #$.       #
             ##  ###  ##
              #########
