   #####
   #   #
   #   #
####$  #
#.. $  #
#..$  ##
#..# $#
# .#$ ##
#### $ #
  # $  #
  #  @ #
  #####
