 ####
 #@ ###
 # $  #
### # ##
#.# #  #
#.$  # #
#.   $ #
#######
