          #####
    #######   ######
   ##    ## #      #
   #  # $ #   $ $$ #
   #$ #     ###$#@$#
  ##  #$####### $$ ####
###  ##  $  ###    #  #
# $ $ # #   ##  #  $$ #
#   $   $ $ ##  #$##  #
##### #  $  ###    # ##
    # ###  $$...#  # #
    # #####.###.. $$ ##
   ##$##......#.##    #
   #    ...#  #.#  $# #
   #   #.#.....*.  $  #
   ########.. #. ###  #
          ######## ####
