            ####
   ##########  #
   #           #
   ##$#######  #
 ####@####### ###
 #   $   #   $  ##
 #  $ $  #  $ $  #
 # $ $ $ # $ $ $ #
 #$  .  $#$ $#$ $#
 # $   $ # $ $ $ #
 #  $ $  #  $ $  #
 #   $   ##  $  ##
##### ####### ###
#   # #  $  #   #
#      $ $  # # #
#######  $ $    #
      #  $  #####
      #######
