+ ####### ######
+##     ###    #
+#  ###   # $$ ###
+# # @ #  #  $   #
+# #$$$# ####$##.###
       ##       $   $ #...#
       #  #$#$##  #   #...#
       # #  $  # # ## #...#
       # #     # #    #...#
       #  #$$$## #$   #...#
       ##         $$###...#
        # #$#$## #$    ...#
        # #    # # $   ...#
        # #    # #  #######
        # #$$$## #  #
+#        ####
+###    ###
          ###### 
+
+
+
+
+
+
+
+
+
+
+
+
+
+
++
+
