 #####
 # @ #
 #$$$#
 # $ #
 #...#
##...#
#    #
# $$ #
#  ###
#### 
