     ####
   ###  ##
####  $  #
#   $ $  ####
# $   # $   # ####
#  #  #   $ # #..#
##$#$ ####$####..#
 #   ##### ## ...#
 #$# ##@## ##  ..#
 # #    $     ...#
 #   #### ###  ..#
 ### ## #  ## ...#
  ##$ ####$ ###..#
  #   ##    # #..#
 ## $$##  $ # ####
 #     $$$$ #
 # $ ###    #
 #   # ######
 ####
