####    ####
#..######..#
#..........#
# $ $ $ $ $#
#$ $ $@$ $ #
# $ $ $ $ $#
#$ $ $ $ $ #
#..........#
#..######..#
###     ###
