  #####
  #   #########
  # $ $       #
#####  $ #$$  #
#   # ##    ###
#...   ##  $#
#...#$$  $  #
#...#  @#  ##
###########
