    ###########
    #  ...#...#
    # @.#.....#
    #  ...##..#
    ## .......#
    #  #......#
   ##$$########
   #    $     ####
   #$ $ $  $ $   #
 ###   $$$$$ $   #
 #   $$      $ ###
 #$   ####  ####
 # $#########
 #$ $ $ $   ###
##  # $  $    #
# $ # # $ $   #
#       $$  ###
#########   #
        #####
