##############
#   ## ......#
#  ### ..#.# #
# $#  ..##. .#
## # $# #    #
# $  $    # ##
# $# # $###$ #
#@ # # $  #  #
# $# ##$# #$ #
# $   #      #
###   # ##$ ##
  #####     #
      #######
