       ####
       #@ #
   #####  #
####      #
#   .### ##
# # #    ##
# # $ $#. #
# #  *  # #
# .#$ $ # #
##    # # #
 # ###.   #
 #     ####
 #######
