       ####
    ####  #
   ##  #  #
   #  $ $ #
 ### #$   #### 
 #  $  ##$   #
 #  # @ $ # $#
 #  #      $ #####
 ## ####$##      #
 # $#.....# #    #
 #  $..... $# ####
##  #.....#   #
#   ### #######
# $$  #  #
#  #     #
######   #
     ####
