 #################
 #...   #    #   ###
##.....  $## # # $ #
#......#  $  #  $  #
#......#  #  # # # ##
######### $  $ # #  ###
  #     #$##$ ## ##   #
 ##   $    # $  $   # #
 #  ## ### #  #####$# #
 # $ $$     $   $     #
 # $    $##$ ######## #
 #######  @ ##      ###
       ######          

