       #########
       #       #
       # $$$$$ #
       # $ $   #
   #####  $ $  #
   #   #### ####
   #         #
   ### ###   #
    #....## ##
    #....#  #
    #....#  #
#####.###   #
#  ## ### ###
# $##$###  ## 
#      $   #
# $#   ##  #
##@#########
 ###
























