       #####
 #######   ##
##@#  ## $  #
#    $    $ #
#  $  ###   #
### #####$###
# $  ### ..#
# $ $ $ ...#
#    ###...#
# $$ # #...#
#  ### #####
###
