     ####
######  #
#    $  ###########
# ## $  ##  # ....#
# $ $  $    # ....#
# #  $$ ### # ....#
# @$$    ## # ....#
####  #  #  ## ####
   # $####     #
   #$ $ ####$# #
  ## #  #  # # #
  #  $$$       #
  #     #####  #
  #  ####   ####
  ###
