         ####                
         #  #                
         #  ########         
   #######  #      #         
   #   # # # # #   ##        
   # $     $  ##  $ #        
  ### $# #  # #     #########
  #  $  #  $# # $$ #   # #  #
 ## #   #     ###    $ # #  #
 #  #$   # ###  #  # $$# #  #
 #    $## $  #   ## $  # # ##
####$ $ #    ##  #   $    ..#
#  #    ### # $ $ ###  ###.$#
#     ##  $$ @  $     ##....#
#  ##  ##   $  #$#  ##....$.#
## #  $  # # $##  ##....$.###
## ##  $  # $ #  #....$.###  
#    $ ####   # ....$.###    
#   #  #  #  #  ..$.###      
########  ###########        
