       #########
       #       #
       # # # # #
       #  $ $# #
       #   $   #
       ## $ $# #
 ###    # $ $  #
##.###### ######
#...  # $ $ #
##..     $  #
#...  #  @###
##.####  ##
 ###  ####
