 ########
 #@##   ####
 # $   $   #
 #  $ $ $$$#
 # $$# #   #
##$    $   #
#  $  $$$$$##
# $#### #   #
#  $....#   #
# ##....#$$ #
# ##....   ##
#   ....#  #
## #....#$$#
 # #....#  #
 #         #
 #### ##$###
    #    #
    ######
