#####
#   ##
#    #  ####
# $  ####  #
#  $$ $   $#
###@ #$    ##
 #  ##  $ $ ##
 # $  ## ## .#
 #  #$##$  #.#
 ###   $..##.#
  #    #.$...#
  # $$ #.....#
  #  #########
  #  #
  ####
