          ###
         #   #
        #  $  #
       # # @ # #
      # #  $  # #
     # #  $ $  # #
    # #  $ $ $  # #
   # #  $ $ $ $  # #
  # #  $ $ $ $ $  # #
 # #  $ $ $ $ $ $  # #
# #  $ $ $ . $ $ $  # #
 # #  $ $ $ $ $ $  # #
  # #  $ $ $ $ $  # #
   # #  $ $ $ $  # #
    # #  $ $ $  # #
     # #  $ $  # #
      # #  $  # #
       # #   # #
        # # # #
         # # #
