       ####
########  #####
#         #   #
#    # ##  #  ####
##  #     #      ###
 #   ##   # $$$#   #
 #         #   $ $ #
 #  #  # # #$# @# ##
 ####  $ $ #   $  #
  # $ ##### ### $##
  #  ........... #
  ###  #######  ##
    ####     ####
