                #######
                #  #  ####
                # $#$ #  ##
         ########  #  #   ########
         #....  . $#$ #  $#  #   #
         #....# #     #$  #      #
         #..#.    $#  # $    #$  #
         #... @##  #$ #$  #  #   #
         #.... ## $#     $########
         ########  #$$#$  #
                # $#  #  $#
                #  #  #   #
                ####  #####
                   ####
