       ####
########  ####
#   ##.....  #
#  $  ##...# #
##  $  ### # #
 # # $  #    #
 #  # $  #   #
 #   # $  #  #
 #    # $ # ##
 ####  # $  #
    ##  # $ #
     ##@#   #
      ######
