   #####
  ##   ######    ####
  #  $      ######  #
  # # #####$#       ##
  # # #   $ $ # ## . #
  # # # ### # #$## . #
### #$# ### $ $ ##...#
#   # #        $ #...#
# ### #####  $ # #...#
# $  @  $   $  # #...#
# ### ##### #### #...#
#   # #   $ #  $ $...#
### #$#   # #  # #####
  # # ### # #    #
  # #   # # ##$###
  #   # # #    #
  ###   # ### ##
    ##### $  $ #
        #      #
        ########
