 ###############
 #  # @ #  #   ##
 #$   $   $$  $ ##
## ###$##  ##  $ ##
# $ .#  ##  ##  $ #####
#..*.$  #  #  #    #  #
#.*.*#  # $    # $  $ #
#.*.. $ #####  ##  #  #
#..**#   #    ### ## ##
#..*. $  #  $    $   #
#.*..#   #     #  #  #
######################
