                #####
              ###   ###
             ## @ $ $ #
             #  ## ## ##
             # $.#.$   #
             # #.#*#   #
             # $...  ###
             ###$# ###
               #   #
               #####  



          ######    ####
          #    ######  #
          # #          ##
         #####    ####  ##
         #        #      ##
         #     # ## ###   #
         #           #    #
        
