  ##########
 ##     #  ############
 #  $$  #       ##  $ #
 # $  $ # $$ $$ #  $  #
##$ $$ $# $ $ $ # $   ###
#@$       $ $ $ .$ $$$$.#
##$ $$ $# $ $ $ # $   ###
 # $  $ # $$ $$ #  $  #
 #  $$  #       ##  $ #
 ##     ###############
  #######
