    ######
    #    #
  ### ## #
###  $  $#######
#   $ $  #  ...#
# #$ #  $#  ...#
# #  #$     ...#
# #$ #   #  ...#
# # $# $$#  ...#
# #@ #$  #######
# # $ $ ##
# #  $  #
# ### ###
#     #
#######
