#####
#   #####
# $ $ $ #
### # # #
  # #   #
 ## ### ##
 # .....@#
 # $ $   #
 # ### ###
 #     #
 ######
