   ####               
   #  ######          
  ##    #  ########## 
  #   #  $ #  #     # 
### # ###  # $  $ # # 
#   #$  ## #  ## ## ##
# ###@#  # ##...$$ $ #
#  .$.$.$    ...  #  #
### #$## #$##..#  # ##
  #  .#    ###.## # # 
  ###$# #### #.  $  # 
    #   #    ###   ## 
    #####      #####  
