 #####
 #   #######
 # $ ###   #
 # $    $$ #
 ## ####   #
### #  # ###
#   #  #@##
# $$    $ #
#   # # $ ####
##### #   #  #
 #   $####   #
 #  $     $  #
 ##   ##### ##
 ##########  #
##....# $  $ #
#.....# $$#  #
#.. ..# $  $ #
#.....$   #  #
##  ##########
 ####
