        ########
        #      #
        #  $ $ #
 ######## $ $  #
##...  #### ## #
#....       ## #
##...  ## $$## ##
 ######## $    @#
      ### #### ##
      # $ $    #
      #  $ #####
      ##   #
       ##### 
