               ####
          ######  #####
    #######       #   #
    #      $ $ ## # # #
    #  #### $  #     .#
    #      $ # # ##.#.#
    ##$####$ $ $ ##.#.#
    #     #    ####.###
    # $   ######  #.#.#
######$$$##      @#.#.#
#      #    #$#$###. .#
# #### #$$$$$    # ...#
# #    $     #   # ...#
# #   ## ##     ###...#
# ######$######  ######
#        #    #  #
##########    ####
