 #####             
 # # ######
 #      $@######
 # $ ##$ ###   #
 # #### $    $ #
 # ##### #  #$ ####
##  #### ##$      #
#  $#  $  # ## ## #
#         # #...# #
######  ###  ...  #
     #### # #...# #
          # ### # #
          # #     #
          #########
