#### ####
#  ###  #
#    $  #
#  # #  #
## # #$##
#  #.#  #
#  *.* @#
#  #.# ##
####   #
   # #$#
   #   #
   #####
