       ############
       #..........#
     ###.#.#.#.#..#
     #   .........#
     #@ $ $ $ *.*.#
    ####### #######
 ####   #    ##  #
##    $ #    # $ ##
#  #$# ### ###$   ##
# $  $ $   # $ $ $ #
#  # $ ##       #$ #
#   $####$####$##  #
####  ##   #    #  #
   #$ ##   # # $$  #
   #   # $ #  $    #
   ### # $$ #  $ ###
     # #    # $ ##
     # ######## #
     #          #
     ############
