########
#      #
# #$$  #
# ...# #
##...$ ##
 # ## $ #
 #$  $  #
 #  #  @#
 #######
