##### ####
#$$$# #  ####
#...### $$  #
#....##  $ $###
##....##   $  #
###... ## $$$ #
# ##  @ #     #
#  ## # ### ####
#   # #  $     #
#          $ $ #
#   #   $ $$ ###
#  ######  ###
# ##    ####
##
