
        #########
      ###   #   #
      #@$  $ $$ #
##########      #
#.###   ##  ##$ # 
#.....$.  ## $  #
# $##  #$ #  $  #
#   #  $  ......#
## $##  #########
 # $ ####
 # $ $ #
 #     #
 ######
