##################
#         ## #...#
# $ $$#    $ #...#
# $   #$##$$ #...#
# $$#$       @...#
# $ $ $#$ ####  .#
#   ##       $...#
#################
