          ###
          #.###
      #####...##
      #  # ....#
      #  # #   #
  ##### .#  # $##
  #   #...#   $ # ####
  #   .   .## $ ###  #
  ## ##  #$ # $      #
  ##.# $## $##  ###  #
 ## .*    $   $ #  $###
## $.#$#  $ $  #  $   #
# $ .#   # ###  $$  $ #
#   .#####     ##  #@ #
######   ############## 
