 ####
 #  ####
 #$ @  #
##  ##$##
# +#.#  #
# ..+$$ #
# .#.#  #
##   # ##
 ### $  #
   # #  #
   #   ##
   #####
