  ########
  #      #
  #  $   #####
  ####   $   #
  #  ##$# $  #
  #    @# # #####
 ## ## $ $ $$   #
 #   #  #   #   #
##   ############
#....#
#....#
######
