    #########
  ###   ##  #####
###      #  #   ####
#  $$ #$ #  #  ... #
# #  $#@$## # #.#. #
#  ## #$  #    ... #
# $#    $ # # #.#. #
#    ##  ##$ $ ... #
# $ ##   #  #$#.#. #
## $$  $   $  $... #
 #$  ######    ##  #
 #   #    ##########
 ####
