   ##########
   #  ###   #
   # $   $  #
   #  ####$##
   ## #  #  #
  ##  #.$   #
  #  ##..#  #
  # @ #.$# ##
  # #$#..#$ #
  # $ #..#  #
  # # #$$#  #
  # $ #..#$##
  #    .$#  #
 ###  #  #  #
##    ####  #
#  #######$##
# $      $  #
#  ##   #   #
#############
