#####
#   ######
# $   $  ##
#  $ $  $ #
#    #$#  #
##$ $   $ #
 #  $    ##
 #####$##
 #   #@ #####
 # $  $ $   #
 ##$##  #   #
  # ######$##
  # #       #
 ##   #######
 #  ###....#
 #     ....#
 ##    ....#
  #####....#
      ######

