              ######
          #####    #
          #  ## #  #####
          #   *.#..#   #
 ##### #### $#.#...    #
 #   ###  ## #*....## ##
 # $      ## #..#..## #
###### #   # #*.##### #
#   # $#$# # #..##### #
# $  $     # #*.    # #
## ##  $ ### #  ##  # #
 #  $  $ ### ##### ## #
 ###$###$###  #### ## #
#### #         ###  # #
#  $ #  $####  ###$$#@#####
#      $ # #  ####  #$#   #
#### #  $# #              #
   #  $  # ##  ##  ########
   ##  ###  ########
    ####

