 ####
 #  #
 #$ ###
 #   @#
## #. ###
#  #*.$ #
# $$..# #
## ##.  #
 # $  ###
 #  ###
 #  #
 ####
