  #########
  #*.*#*.*#
  #.*.*.*.#
  #*.*#*.*#
  #.*.*.*.#
  #*.*#*.*#
  ###@  ###
    #   #
###### ######
#   $   $   #
# $   $   $ #
## $ $$$ $ ##
 #$$      $$#
 #   $ $   #
 #  #####  #
 ####   ####
