#############
#  $ $ $.+..#
# $ $ $ +...#
#  $ $ $.+..#
# $ $ $ +...#
#  $ $ $.+..#
# $ $ $ +...#
#  $ $ $.+..#
# $ $ $ +...#
#  $ $ $.+..#
#@$ $ $ +...#
#############
