########
#  #   #
# $..$ #
#@$.* ##
# $..$ #
#  #   #
#######
