      #############
      #           #
      # ## $ #$ # #
      #   $ $  $  #   #####
      ## $ $ $ ########   #
########### #  # $        #
#    #  #   #  # # ##### ##
# #$ #  #   #  # $ #   # #
#   $   ##$### $   #  .# #
#  # $ #     #  $ ###. # #
# ###@$#     # ..##...## #
###  $ #  # ## ..##  .## #    
#   $  #### #.....##  .# #
## $ $      #......#   # ##
#   #  ###  #########$##  #
######## ####       #     #
                    #  ####
                    ####
     
