    #########
    #       #
    #$$ $$# ####
#####  #  $ #  #
#..#  ## $  $  #
#..# $$     #  #
#..#  ##$#### ##
#..## ##    # #
#...   ## ### ###
#   ##   $      #
######@#   ## # #
     ########   #
            ####
