###########
#......   #########
#......   #  ##   #
#..### $    $     #
#... $ $ #  ###   #
#...#$#####    #  #
###    #   #$  # $###
  #  $$ $ $  $##  $ #
  #  $   #$#  ##    #
  ### ## #  $ #######
   #  $ $ ## ##
   #    $  $  #
   ##   # #   #
    #####@#####
        ###
