            ####
 ############  #####
 #    #  #  $  #   ##
 # $ $ $  $@# $ $   #
 ##$ $   #  # $   $ #
###   ############ ##
#  $ $#  #......# $#
# #   #  #......## #
#  ## ## #......#  #
# #      $...... $ #
# # $ ## #......#  #
#  $ $#  #......# $#
# $   #  ##$#####  #
# $ $ #### $ $  $ $#
## #     $ $ $ $   ###
 #  ###### $    $    #
 #         # ####### #
 ####### #$          #
       #   ###########
       #####
