  ####
  #  #########
 ##  ## @#   #
 #  $# $ $   ####
 #$  $  # $ $#  ##
##  $## #$ $     #
#  #  # #   $$$  #
# $    $  $## ####
# $ $ #$#  #  #
##  ###  ###$ #
 #  #....     #
 ####......####
   #....####
   #...##
   #...#
   #####
