 #######
 #  #  #####
##  #  #...###
#  $#  #...  #
# $ #$$ ...  #
#  $#  #... .#
#   # $########
##$       $ $ #
##  #  $$ #   #
 ######  ##$$@#
      #      ##
      #######
