  ##################
  #       ##...#   #
  # #$#$# ###... $ #
  #  @$  $   ..# $ #
#####$#$# #  ..  ###
#   $ $ # ###### ##
# # # # #         #
#       #######   #
#########     #####
