######  #####
#    ####   #
# $   $   # #
##  # ### $ #
 #$$  ###$# #
##   #  ... #
#  # $  $...#
#  #####..###
# @#   ####  
####
