        #####
        #   ####
        # $    ####  ####
        #   # $#  ####  #
########### #   $   #   #
#..     # $  #### #  #  #
#..$  #   $  #  $ # $ .##
#.*# #@$ $ ##        .#
#..#    #             .#
#..# $ $  $ $ ##   ## .#
#.*$$ # ##   $ #$# $ #.#
#..#      ##   #     #.#
#..#######  ### ######.##
# $$                  *.##
#  ##################  ..#
####                ######
