      ###########
      #     #   ##
      # $      ..#
      #     #$#..#
  ###########  ..#
  #      $     ..#
  # # # $## # #..#
  #   #$    #  ..#
 ##$# $ #######  #
##   $  #    # $ #
#   $  ##    #   #
#  $   ##    #####
# $#####
# @#
####
