 #########
 #   #   #
 # $$$$$ #
## $ $ $ #
# $  @   #
# $ #### ##
#  #..... #
##  ..... #
 ##########
