 ####
 #  ######
 #     $@#
## ##.##$#
#  # . # ###
#   $..#   #
## # . $ # #
## ##.#  $ #
#  ##.# ####
# $$ $#  #
#  #     #
#######  #
      ####
