        #########
   ######   ....#
  ##        ....#
###  # ###  ....#
#  ### ###  ....#
#  #     #  ....#
#  #  $ $########
#  # $$$  #     #
#  # $ $ $#  @  ####   
#  # $$$     #   #
#  ### # $###### ### #
#   #    #  $  $ $ # #
#   #### #  $ $ $ #  #
###     ###  ##    # #
  #                  #
  ####             ###
     ###  ####     #
       ####  #   $ #
             #   ###
             #####
