+  ######
+  #   @####
+##### $   #
+#   ##    ####
+# $##  ##    #
+#   #  ##### #
+# #$$ $    # #
+#  $ $ ### # #
+# #   $  # # #
+# #  #$#   # #
       ## ####   # # #
       #  $  ##### # # ####
      ##    $     $  ###  ####
  #####  ### $ $# $ #   .....#
  #     ##      #  ##  #.....#
  # $$$$    ######$##   #.##.#
  ##    ##              #....#
   ##  ###############   ....#
    #  #             #####  ##
    ####                 ####
