
   ######
   #    #
 ###$$$ #
 #  $.. #
 #@$...##
 ####  #
    ####
