 ####### ######
 #     ###    #
 #  ## #  $$# ##
 #$ $ $ $ $    #
 # $ $ #   #   #
##  $$ ######.##
# $    #   #...#
#@#$$ ##   #...#
#  $   #   #...#
##  #$ #   #...#
 #$$#  #####...#
 #     $    ...#
 ###########   #
           #####
