

          ######    ####
          #    ######  #
          #@# $        ##
         #####$ $ ####  ##
         #    $   #      ##
         #  $$ # ##$###$$ #
         #     $*.*..#    #
         #######....*# $  #
               #*..*.# #$##
               #....* $   #
               #.....# $$$#
               ##### # #  ##
                   # # $ $ #
                   #  $    #
                   #  ###  #
                   #### ####
