 #########
 #....   ##
 #.#.#  $ ##
##....# # @##
# ....#  #  ##
#     #$ ##$ #
## ###  $    #
 #$  $ $ $#  #
 # #  $ $ ## #
 #  ###  ##  #
 #    ## ## ##
 #  $ #  $  #
 ###$ $   ###
   #  #####
   ###
