        ########
   ######  ....#
  ##       ....#
###   ###  ....#
#   # ###  ....#
# ###   #  ...##
# #  $ $########
# # $$$   #   #####
# # $ $ $ # @ #   ###
# # $ $$$   #   #   #
# #   $  ###### ### #
# ### # $##   $   # #
#   #    ## $ $ $ # #
### #### ### ### ## #
  #    # ###  ## #  #
  ####        ## # ##
     ###  ####   # #
       ####  #  $  #
             #   ###
             #####
