    ######
    #    #
 ####  $$#####
 #   #   #   #
 # $   $   $ #
 #   ## #############
####$##      #      #
#   $ #   @  # $ $  #
# $ $ # ###### $## ##
##  $ # #....##     #
 # ##    ....## $#  #
 #    ##......   #  #
 #############  #####
             ####
