 ######
 #. . #
 # @ .###
 #     .#
##$ $ ###
# $$  #
#     #
#######
