#######
# ....#
# ....#
# ....#
##$#########
# $ $      #
#   # $$ $ #
### #   #$ #
  # # $$   #
  # # # $$ #
  # #  $ ###
  # ###  #
  #    #@#
  ####   #
     #####
