       #########
########@##  ..#
#      $     ..#
# $ #$ #$##  ..#
## ##    ####..#
 # $ $## #  ####
 # ## #  #
## #    ##
#  $   ##
#  ##$ #
#  ##  #
########
