           #####
          ##   ## 
         ##     #
        ##  $$  #
       ## $$  $ #
       # $    $ #
####   #   $$ #####
#  ######## ##    #
#..           $$$@#
#.# ####### ##   ##
#.# #######. #$ $###
#........... #   $ #
##############  $  #
             ##  ###
              ####
