######
#    #
# $$$##
#  #..###
##  ..$ #
 # @    #
 #######
