####
#  ###
# $  ###
# $ $  ###
# $ $ $  ###
# $ $ $    #
# $ $  #   ##
# $  ## $$$ #
#@ ####     ##
## # #.$$$$$.#
 # ###.......##
 #   .........#
 ####.........#
    ##########
