########
#..    ########
#...      $   ##
#.... ## $ #$  #
#.... #  #  $  #
#######$ ##  $ ###
 #        ### $  #
 #  $ # $  #  $  #
 #  ### ##  # ####
 #  #  $  $ #   #
 #### #$#   ##$  #
  #     $$    $  #
  #####@  #######
      #####
