              ###
             ##.###
             #....#
 #############....#
##   ##     ##....#####
#  $$##  $ @##....    #
#      $$ $#  ....#   #
#  $ ## $$ # #....#  ##
#  $ ## $  # ## ###  #
## ##### ###         #
##   $  $ ##### ###  #
# $###  # ##### # ####
#   $   #       # 
#  $ #$ $ $###  #
# $$$# $   # ####
#    #  $$ #
######   ###
     #####
