     #########
     #    ...#
     # #  ...#
     # ##  ..#
###### $ $ ###
#...$ $ $@##
#..# $ $ $########
#...# $ $        #
#... $ $  #$#$## #
#  #### $ $ $ #  #
#  #  #  $   $   #
####  ##   #######
       #####
