       #####
  ######   #
###    . $ #
# $  #$.#$##
#  #  @.#  #
## ####.   #
 # $  #*####
 # ## #.  # 
 ###$     #
   #  #####
   ####    
