##########
#        ####
# ###### #  ##
# # $ $ $  $ #
#       #$   #
###$  $$#  ###
  #  ## # $## 
  ##$#   $ @#
   #  $ $ ###
   # #   $  #
   # ##   # #
  ##  ##### #
  #         #
  #.......###
  #.......#
  ########
