######
#    ###      ######
# #  $ #  ### #   ..#
# #  $ ####@###   ..##
#  $$$   $        ...#
###  $  $######   ..##
  #$ $ $ #    #   ..#
  #      #    #######
  #######
