######
# $. #
#@* ##
# $. #
######
