  #####
###   ####
#   $ $  #
# $   $ @#
###$$#####
  #  ..#
  #....#
  #####
