         ####
 #########  ##
##  $      $ #####
#   ## ##   ##...#
# #$$ $ $$#$##...#
# #    @  #   ...#
#  $# ###$$   ...#
# $  $$  $ ##....#
###$       #######
  #  #######
  ###
