        ########
        #     @#
        # $#$ ##
        # $  $# 
        ##$ $ #
######### $ # ###
#....  ## $  $  #
##...    $  $   #
#....  ##########
#######
