  ####
###  #########################
#                      #.....#
#     #              @  .....#
#       ######  ###     ..#..#
#  ###$#   #  $$  #   #  #...#
##     #   $$  $# ##   ## .#.#
#   ## # $#  $  #    $  # ...#
#  ## $## $  #  $$ ###  # ...#
#   #    $  ##$ # #       # ##
#   #  ###$$   ## #   #   #  #
#   #### # $ $ # $  #     #  #
#        #  #$    $ #   #    #
# # $$$   # # #  #    ####   #
#   #       #  ## #       #  #
#      #   #      ####       #
#    ##                      #
######################  ######
                     ####
